{
  "id": "default_board",
  "map": [
    "222222222222000",
    "222222222222000",
    "222222222222000",
    "222222222222000",
    "111111111111000",
    "111111111111000",
    "111111111111000",
    "111111111111000",
    "000000000000000",
    "000000000000000",
    "000000000000000",
    "000000000000000",
    "000000000000000",
    "000000000000000",
    "000000000000000"
  ],
  "obstacles": [
  ],
}
